########################################
#                                      #
#   #######                            #
#                                      #
#               #######                #
#                                      #
#                                      #
########################################
